BBBBBBBBBBBBBBBBBBBBBBBBBBBBBBBBBBBBB
BBBBBBBBBBBBBBBBBBBBBBBBBBBBBBBBBBBBB
BBBBBBBBBBBBBBBBBBBBBBBBBBBBBBBBBBBBB
BBBBBBBBBBBBBBBBBBBBBBBBBBBBBBBBBBBBB
BP       B                          B
BBBB    EB                         CB
BB   BBBBB                        BBB
B  B                             B  B
B    B                             BB
B      B                    B EB   EB
BBB  BBBBBB                 BBBBBBBBB
BE     EBBBB             BB         B
BBBB BBBBBBBB    BBB   BBB          B
BBBCCCBBBBBBBB               E      B
BBBBBBBBBBBBBBB     B BBBBBBBBBBBBBBB
BBBBBBBBBBBBBBBB                    B
BBBBBBBBBBBBBBBBB                 CFB
BBBBBBBBBBBBBBBBBBB         EE   BBBB
BBBBBBBBBBBBBBBBBBBBBBBBBBBBBBBBBBBBB
BBBBBBBBBBBBBBBBBBBBBBBBBBBBBBBBBBBBB
BBBBBBBBBBBBBBBBBBBBBBBBBBBBBBBBBBBBB
BBBBBBBBBBBBBBBBBBBBBBBBBBBBBBBBBBBBB
BBBBBBBBBBBBBBBBBBBBBBBBBBBBBBBBBBBBB
BBBBBBBBBBBBBBBBBBBBBBBBBBBBBBBBBBBBB