BBBBBBBBBBBBBBBBBBBBBBBBBBBBBBBBBBBBB
BBBBBBBBBBBBBBBBBBBBBBBBBBBBBBBBBBBBB
B           E   E   E   E           B
B BBBBBBBBBBBBBBBBBBBBBBBBBBBB BB  CB
B BBBBBBBBB     E    E   E     BB  BB
B       BBB  BBBBBBBBBBBBBBBBBB    BB
BBBBBBB BCB  BBBBBBBBBBBBB      BBBBB
B E E   BBB  EEE     CBBB       BBBBB
B BBBBBBBBBBBBBBB BBBBBBB    BBBBBBBB
B  E E  BCCE E E  BCEE            BBB
BBBBBBB BBBBBBBBBBBBBBBBBBBB        B
B            BB                  ECEB
B BBBBBBB    BB BBBBBB BBBBBB    BBBB
B   E E B    BB BBBBBB BBBBBBBB  BBBB
BBBBBBB B    BB   B            B    B
B E  E  BBEECBBBB B   B        B    B
B BBBBBBBBBBBBBBB B   B        B    B
B   FBBBC E E E   BCEEBE E E CCB BBBB
BBBBBBBBBBBBBBBBBBBBBBBBBBBBBBBB BBBB
BBBBBBBBBBBBBBBBBBBBBBBBBBBBBB   BBBB
B                              BBCCCB
BCCC                           BBCCCB
BCCCB E B E E E E E BE BE B EBPBBCCCB
BBBBBBBBBBBBBBBBBBBBBBBBBBBBBBBBBBBBB