BBBBBBBBBBBBBBBBBBBBBBBBBBBBBBBBBBBBB
BBBBBBBBBBBBBBBBBBBBBBBBBBBBBB   BBBB
BCCC   E E E E E E                  B
BBBBBBBBBBBBBBBBBBBBBBBBBBBBBBBB    B
BP       B                      B   B
BBBB   EEBCC                 EECB   B
BB   BBBBBBBB              BBBBB  BBB
B  B            E E E            B  B
B    B          BBBBBBBBBB          B
BE    EB                      EB E CB
BBB   BBBBB                 BBBBBBBBB
BEE   EEBBBB             BB         B
BBBB BBBBBBBB    BBB   BBB          B
B  CCCBBBBBBBB             E E  E ECB
B BBBBBBBBCBBB      B BBBBBBBBBBBBBBB
B BBBBBEECCCEEBB           EEC      B
B   BBBBBBBBBBBBB        BBBBB    CFB
BBB BBBBBBBBBBBBBBB     EEE      BBBB
BBB       E E ECBBBBBBBBBBBBBBBBBBBBB
BBBB BBBBBBBBBBBBBC E  E  E        BB
BBBB BBBBBBBBBBBBBBBBBBBBBBBBBBBBB BB
BBBB       E E   E  E  E   E   CC   B
BBBBBBBBBBBBBBBBBBBBBBBBBBBBBBBBBBB B
BCCC     E  E  E  E  E  E  E  E     B