BBBBBBBBBBBBBBBBBBBBBBBBBBBBBBBBBBBBB
BCEE               PBB              B
BBBBBBB          BBBBBC            CB 
BC               BBBBBBB   EEEEEEECCB
BC EEEE             BB     BBBBBBBBBB
BBBBBBBBBBBB BBBBBB BB       EEEEECCB
B        ECB BBB    BB   BBBBBBBBBBBB
B    BBBBBBB BBB    BBBB           BB
B    BB          BBBBBEE           BB
BE   BB BBBBBBBBBBBBBBBBBBBBBB      B
BBB         E  E  E  E  E  E        B
BBBBBBBBBBBBBBBBBBBBBBBBBBBBBBBBBBB B
B                                   B
BCEEE                               B
BBBBBBBB                           BB
B                                  BB
B      BBB                         BB
B             BBB                  BB
B                                BBBB
B        BBB       BBBBBB        BBBB
B                           BBB  BBBB
B   BBBB                            B
B                  X               FB
BBBBBBBBBBBBBBBBBBBBBBBBBBBBBBBBBBBBB