BBBBBBBBBBBBBBBBBBBBBBBBBBBBBBBBBBBBB
BC                           E  E CCB
BBBB                    BBBBBBBBBBBBB
B              E  E  E B            B
B   BBBBBBBBBBBBBBBBBBBB     EECCCE B
BC                          BBBBBBB B
BBB                       BB        B
B                        BB         B
BCE                     BB         FB
BBBBBBB          B    EB          BBB
B          BBB   BBBBBB          C  B
B         BBBB               C   B  B
B        BBBBB               B   B  B
BP      BBBBBBB    E  E  E BEB EEB EB
BBBBBB   BBBBBBBBBBBBBBBBBBBBBBBBBBBB
BBBBBB   BBBBBBBBBBBBBBBBBBBBBBBBBBBB
B           E    E     E           CB
BEBBBBB BBBBBBBBBBBBBBBBBBBBBBBBBBBBB
BCBBBBB BBBBBBBBBBBBBBBBBBBBBBBBBBBBB
BB            E   E   E   E   E  ECCB
BB BBBBBBBBBBBBBBBBBBBBBBBBBBBBBBBBBB
BB BBBBBBBBBBBBBBBBBBBBBBBBBBBBBBBBBB
BB      E  E  E  E  E  E  E E E ECCCB
BBBBBBBBBBBBBBBBBBBBBBBBBBBBBBBBBBBBB