BBBBBBBBBBBBBBBBBBBBBBBBBBBBBBBBBBBBB
B                                   B
B  BBBBBBBBBBBBBBBBBB               B
B           E    E  B         E   ECB
BBBBBBBBBBBBBBBBBBB BBB    BBBBBBBBBB
BBBBBBBBBBBBBBBBBBB BBBB            B
BFE E E E E         BBBB            B
BBBBBBBBBBBBBBBBBBBBBBBBBB          B
B                         B         B
B                              EB  EB
B                            BBBBBBBB
B            E      E    E          B
B        BBBBBBBBBBBBBBBBBBB        B
B       B                 B B       B
B    BBBBCCE E  E E       B    B    B
B        BBBBBBBBBBBBBBB  B    B    B
BBE                       BCE  B  ECB
BBBBBBBB                 BBBBBBBBBBBB
B       BB                BBBBBBBBBBB
BC        BB   BBB   BBB            B
BBB B  B          B B        B   C  B
BE    EB E   B E  BPBC E E B  E  B EB
BBBBBBBBBBBBBBBBBBBBBBBBBBBBBBBBBBBBB
BBBBBBBBBBBBBBBBBBBBBBBBBBBBBBBBBBBBB