BBBBBBBBBBBBBBBBBBBBBBBBBBBBB
B                           B
B                           B
B                           B
B                           B
B                           B
B                           B
B                           B
B                          FB
B                         BBB
B                        C  B
B                    C   B  B
B                    B   B  B
B              P   BEB  EB  B
BBBBBBBBBBBBBBBBBBBBBBBBBBBBB